S	./textures/medkit.xpm
R	1024 576
NO ./textures/wolftex/pics/greystone.png
SO ./textures/wolftex/pics/mossy.png
WE ./textures/wolftex/pics/wood.png
EA ./textures/wolftex/pics/bluestone.png 
 
C	255, 0, 0
F	25, 1, 0

11111111	111
10121001	101
10100001	111
10101001
1000000111111111
1000010000020001
1020000000000001
1000000111111111
10101001
10101001
10101201
10101001111111111
10101000000000001
111111111111000S1
           100001
           111101
             1101
111111111111111011
100000000000000001
100000011111111111
10000001
10000001
10000001
11111111
11111
1
