R 1400 800
NO ./textures/wolftex/pics/greystone.png
SO ./textures/hitler.xpm
WE ./textures/wolftex/pics/wood.png
EA ./textures/wolftex/pics/wood.png
S ./textures/beer.png
F  150,1,1
C  1,1,0

1111111111111111111111111111
1222222222222222222222222221
1222222222222222222222222221
1222222222222222222222222221
1222222222222222222222222221
1222222222222222222222222221
1222222222222222222222222221
1222222222222222222222222221
1222222222222202222222222221
1222222222200000002222222221
1222222222200000002222222221
1222222220000000000022222221
1222222220000000000022222221
1222220000000000000000222221
1222220000000000000000222221
1111111111111101111111111111
             101
             101
             101
             101
             101
             101
             101
             101
             101
             101
             101
             101
             101
             101
             101
             101
             101
             101
             101
             101
             101
             101
             101
             101
             101
             101
             101
             101
             101
             101
             101
             101
             101
             101
             101
             101
             101
             101
             101
             101
             101
             101
             101
             101
             101
        1111110111111
        1000000000001
        1000000000001
        100E000000001
        1000000000001
        1000000000001
        1000000000001
        1000000000001
        1000000000001
        1000000000001
        1000000000001
        1000000000001
        1000000000001
        1111111111111