R 1400 800
NO ./textures/wolftex/pics/greystone.png
SO ./textures/wolftex/pics/mossy.png
WE ./textures/wolftex/pics/wood.png
EA ./textures/wolftex/pics/bluestone.png
S ./textures/wolftex/pics/barrel.png
F  150,1,1
C  1,1,0

111111111111111
100000000000001
100020000000001
100000000200001
100000000000001
102000000000001
100000000000001
100002000000001
100000000000001
100000000000001
111111111110111
    111212101
    120000001
    110101011
    120000001
    110101011
    100000001
    111111101
    100000001
    100000001
    111111101
    1E0000001
    111111111